11111111111111111
10000003003000021
10101013101010101
10000003003000001
10101013101313131
10000003000000001
10101013101010101
13333333333333331
10101013101010101
10000003000000001
13131313101010101
10000303000000001
10101313101010101
12000303000000001
11111111111111111